################################
#.#........#...#................
#.#.##.###.#.#.#.#.#########.###
#...#......#.#.#.#.##......#.###
#.#.########.#.#.#.##.####.#.###
#.#.##.##....#...#.##.#..#.#...#
#......###########....##.#.###.#
#.#######.......##########.#...#
#....####.########.......#.#.###
####.#.##.##...###.#####.#.#...#
#....#.##.##.#.###.....#.#.###.#
#.#.##..#.##.#.#######.#.#.#...#
#.......#.#..#.#...###.#...#.###
####.####.#.##.#.#.###.#####.###
.................#.....#.......#
################################
